109
8
27 0 0 0 0 0 0 0 0 0 0 0 0 0 0 0 0 0 0 0 0 0 0 0 0 0 0 0 0 0 0 0 0 0 0 0 0 0 0 0 0 0 0 0 0 0 0 0 0 0 0 0 0 0 0 0 0 0 0 0 0 0 0 0 0 0 0 0 0 0 0 0 0 0 0 0 0 0 0 0 0 0 0 0 0 0 0 0 0 0 0 0 0 0 26 22 22 22 8 8 8 8 8 8 22 22 22 22 22 
27 0 0 0 0 0 0 0 0 0 0 0 0 0 0 0 0 0 0 0 0 0 0 0 0 0 0 0 0 0 0 0 0 0 0 0 0 0 0 0 0 0 0 0 18 0 0 0 0 0 0 0 0 0 0 0 0 0 0 0 0 0 17 17 17 0 0 0 0 17 0 0 0 0 0 0 0 0 0 0 0 0 0 0 0 0 0 0 0 0 0 0 0 0 26 22 22 27 0 17 17 17 17 17 26 22 22 22 22 
27 0 0 0 0 0 0 0 0 0 0 0 0 0 0 0 0 0 14 0 0 0 0 0 0 0 0 0 0 0 0 0 0 0 0 0 0 0 0 0 0 0 0 0 0 17 17 17 18 0 0 0 0 0 0 0 0 0 0 0 0 0 0 16 0 0 0 23 25 0 0 17 18 0 0 0 0 0 0 0 0 0 0 0 0 0 0 0 0 0 0 0 18 0 26 22 22 27 0 0 0 0 0 0 26 22 22 22 22 
27 0 0 0 0 0 0 0 0 0 0 0 0 0 0 0 0 0 0 0 0 0 0 0 0 0 0 0 0 0 0 0 0 0 0 0 0 0 0 23 24 25 0 0 0 0 0 0 0 17 17 18 0 0 0 0 0 0 0 19 0 0 12 0 0 0 0 0 0 0 0 0 0 17 17 0 0 0 0 0 0 0 0 0 1 30 31 0 0 0 0 0 0 18 26 22 22 27 0 0 0 0 0 0 26 22 22 22 22 
27 0 0 0 0 0 0 0 0 0 0 0 0 1 30 31 0 0 0 0 0 0 0 0 0 0 0 15 0 0 0 0 0 23 24 25 0 0 0 0 0 0 0 0 0 0 0 0 0 0 0 0 17 17 17 17 17 17 17 0 0 0 30 21 31 0 0 0 0 0 0 0 0 0 0 0 0 0 0 23 24 25 0 0 0 26 27 0 0 0 0 0 0 0 26 22 22 27 0 0 0 0 0 0 26 22 22 22 22 
27 0 0 0 0 0 0 0 0 0 1 30 21 21 22 27 0 0 0 0 0 0 0 0 0 0 0 0 0 0 0 0 0 0 0 0 0 0 0 0 0 0 0 1 30 21 21 31 0 0 0 0 0 0 0 0 0 0 0 0 0 0 26 22 27 0 0 0 0 0 0 0 0 0 0 0 0 0 0 0 0 0 0 0 0 26 27 0 0 0 0 0 0 0 0 17 17 0 0 0 0 0 0 0 0 0 0 0 0 
27 0 0 13 0 0 0 0 12 0 0 26 22 22 22 27 0 0 0 0 1 30 21 21 31 0 0 0 0 1 30 31 0 0 0 1 30 31 0 0 0 0 0 0 26 22 22 27 0 11 0 1 0 0 13 0 1 0 0 0 1 30 22 22 27 0 0 0 0 0 0 0 0 0 0 0 11 0 0 0 0 0 0 1 30 22 27 0 0 0 13 0 0 0 0 0 0 0 0 0 0 0 0 0 0 0 0 0 0 
22 21 21 21 21 21 21 21 21 21 21 22 22 22 22 27 0 0 0 0 0 26 22 22 22 21 21 21 21 21 22 22 21 21 21 21 22 27 0 0 0 0 0 0 26 22 22 22 21 21 21 21 21 21 21 21 21 21 21 21 21 22 22 22 27 0 0 0 0 0 0 1 21 21 21 21 21 21 21 21 21 21 21 21 22 22 22 21 21 21 21 21 21 21 21 21 21 21 21 21 21 21 21 21 21 21 21 21 21 
